###########
##   #   ##
## @ #   ##
##$**$**$##
#  #. .# ##
#  .*$*.  #
#         #
###########
