##########
####  #  #
#  #  #  #
# ...$$$ #
# $$$... #
## # #####
## @ #####
##########
