#########
#..  ####
## $$$ ##
## $@$  #
## $$$# #
##..  ..#
###..####
#########
