##########
###   ####
###$*.  ##
#   *   ##
#  @*#####
### *    #
## .*$   #
##   #####
##########
