##################
#..  #  *  #  * .#
#.*  #  $  #  $  #
#.#  #$ #$ #$ #$ #
#.#  $  #  $  #  #
#.#  *  #  #  #  #
#.#############.##
#.#  *  #  #  #  #
#.#  $  #  $  #  #
#.#  #$ #$ #$ #$ #
#.*@ #  $  #  $  #
#..  #  *  #  * .#
##################
