##########
#  #######
# @#######
# $  #####
# $ $#####
# #  $...#
# $ $###.#
# $$ ....#
#     #  #
##########
