##########
#      ###
#   $  ###
#  $ $ ###
## #######
## ##    #
#  #  *  #
#  @ *.* #
#  # .*. #
##   * * #
## #    ##
##########
