#########
####  ###
#   $  ##
#  *** ##
#  . . ##
## * *  #
###***  #
### $ ###
### @ ###
#########
