#########
#@  .   #
# $.#$$ #
# $.*.# #
# *#$.$ #
# $.... #
#.#.*$# #
# $..$. #
# $$#$$ #
#       #
#########
