#########
###  ####
###  ####
###.$.  #
#  $+$  #
#  .$.###
####$ ###
####  ###
#########
