##########
#   ##   #
# * $  * #
# @$..$  #
# #..$ # #
# # $..# #
#  $..$  #
# *  $ * #
#   ##   #
##########
