#######
#. @ .#
# $ $ #
#.$*$.#
# $ $ #
#. * .#
#######
