##########
#    #####
# $.   ###
## .$# ###
# $.$. $ #
#@.$.$ . #
###$.#####
###  #####
##########
