##########
#####    #
###   $. #
## #.$.$ #
## .$.$  #
# @$.$. ##
# $.$.# ##
# .$   ###
#    #####
##########
