###########################################################################################################
#@                                      ###################################################################
#                                       ###################################################################
#                                       ###################################################################
#                                       ###################################################################
#                                       ###################################################################
#                                       ###################################################################
#                                       ###################################################################
#                                       ###################################################################
#                                       ###############################################################   #
#                                       $                                                                 #
#                                       ###################################################################
#                                       ###################################################################
#                                       ###################################################################
#                                       ###################################################################
#                                       ###################################################################
#                                       ###################################################################
#                                       ###################################################################
#                                       ###################################################################
#                                       ###################################################################
#                                       ###################################################################
#                                       ###################################################################
#.                                      ###################################################################
###########################################################################################################
