################
## .  . ########
##. $$$.########
## #  $ ########
##.  *# ########
##.$# $*########
##    $+########
##### ### . $. #
# . $. ##.$   *#
# *.  $   #$$  #
# #$$. ##. $.# #
#  $.#.##.$# $.#
# ## $ ##  $  .#
#  $  .#########
################
