#########
#  @   ##
# $  $ ##
##$## ###
# $..$  #
#  .. . #
#########
