########################################
#                                  ##  #
#@        $ $ $ $ $ $ $                #
#                                  #  .#
#                                  #...#
#                                  #...#
#########################################
