#######
###p .#
# b #.#
#  bb #
#.  # #
#   b.#
#######
